..............
.....┌───┐....
..┌──┘...│....
..│......│....
..└┐.....│....
...│....┌┘....
...└────┘.....
..............
